5' site	3' site	count	skip	5p_before	5p_after	3p_before	3p_after
57	21539	253	21482	CTCTTGTAGA	TCTGTTCTCT	CTAGTGATGT	TCTTGTTAAC
59	28249	186	28190	CTTGTAGATC	TGTTCTCTAA	TTGTTTTAGA	TTTCATCTAA
60	27378	9320	27318	TTGTAGATCT	GTTCTCTAAA	ACCAATGGAG	ATTGATTAAA
61	28250	6457	28189	TGTAGATCTG	TTCTCTAAAC	TGTTTTAGAT	TTCATCTAAA
61	28251	2946	28190	TGTAGATCTG	TTCTCTAAAC	GTTTTAGATT	TCATCTAAAC
61	26464	179	26403	TGTAGATCTG	TTCTCTAAAC	CCTGATCTTC	TGGTCTAAAC
62	28254	554	28192	GTAGATCTGT	TCTCTAAACG	TTAGATTTCA	TCTAAACGAA
63	21549	17894	21486	TAGATCTGTT	CTCTAAACGA	TCTTGTTAAC	AACTAAACGA
63	28253	13079	28190	TAGATCTGTT	CTCTAAACGA	TTTAGATTTC	ATCTAAACGA
63	27881	3702	27818	TAGATCTGTT	CTCTAAACGA	AACTTGTCAC	GCCTAAACGA
63	25378	408	25315	TAGATCTGTT	CTCTAAACGA	ATTACATTAC	ACATAAACGA
63	5784	264	5721	TAGATCTGTT	CTCTAAACGA	AACATATAAC	TTCTAAAGAA
63	26466	230	26403	TAGATCTGTT	CTCTAAACGA	TGATCTTCTG	GTCTAAACGA
64	28254	7012631	28190	AGATCTGTTC	TCTAAACGAA	TTAGATTTCA	TCTAAACGAA
64	26467	215361	26403	AGATCTGTTC	TCTAAACGAA	GATCTTCTGG	TCTAAACGAA
64	26497	268	26433	AGATCTGTTC	TCTAAACGAA	TATTAGTTTT	TCTGTTTGGA
64	27382	225	27318	AGATCTGTTC	TCTAAACGAA	ATGGAGATTG	ATTAAACGAA
65	21551	1117576	21486	GATCTGTTCT	CTAAACGAAC	TTGTTAACAA	CTAAACGAAC
65	25380	618367	25315	GATCTGTTCT	CTAAACGAAC	TACATTACAC	ATAAACGAAC
65	27883	229749	27818	GATCTGTTCT	CTAAACGAAC	CTTGTCACGC	CTAAACGAAC
65	27383	2814	27318	GATCTGTTCT	CTAAACGAAC	TGGAGATTGA	TTAAACGAAC
65	28268	118	28203	GATCTGTTCT	CTAAACGAAC	AACGAACAAA	CTAAAATGTC
66	27384	688112	27318	ATCTGTTCTC	TAAACGAACT	GGAGATTGAT	TAAACGAACA
66	27484	1901	27418	ATCTGTTCTC	TAAACGAACT	ACAGTACTTT	TAAAAGAACC
66	27298	204	27232	ATCTGTTCTC	TAAACGAACT	GATTACATCA	TAAACCTCAT
66	23849	131	23783	ATCTGTTCTC	TAAACGAACT	TGTACACAAT	TAAACCGTGC
67	24776	728	24709	TCTGTTCTCT	AAACGAACTT	CCTGCACAAG	AAAAGAACTT
67	26865	606	26798	TCTGTTCTCT	AAACGAACTT	TTCAATCCAG	AAACTAACAT
67	2291	222	2224	TCTGTTCTCT	AAACGAACTT	GAGAGTGTTC	AGACATTCTT
67	22404	185	22337	TCTGTTCTCT	AAACGAACTT	AATATAATGA	AAATGGAACC
67	29378	149	29311	TCTGTTCTCT	AAACGAACTT	ACAGAGCCTA	AAAAGGACAA
67	22502	143	22435	TCTGTTCTCT	AAACGAACTT	GGAATCTATC	AAACTTCTAA
67	26925	134	26858	TCTGTTCTCT	AAACGAACTT	CCGCTTCTAG	AAAGTGAACT
67	28261	119	28194	TCTGTTCTCT	AAACGAACTT	TCATCTAAAC	GAACAAACTA
67	28258	115	28191	TCTGTTCTCT	AAACGAACTT	ATTTCATCTA	AACGAACAAA
68	28262	37740	28194	CTGTTCTCTA	AACGAACTTT	CATCTAAACG	AACAAACTAA
68	15776	6103	15708	CTGTTCTCTA	AACGAACTTT	TGGCTAGCAT	AAAGAACTTT
68	29153	1216	29085	CTGTTCTCTA	AACGAACTTT	CTAATCAGAC	AAGGAACTGA
68	29111	818	29043	CTGTTCTCTA	AACGAACTTT	CGTGGTCCAG	AACAAACCCA
68	28282	686	28214	CTGTTCTCTA	AACGAACTTT	AATGTCTGAT	AATGGACCCC
68	27676	492	27608	CTGTTCTCTA	AACGAACTTT	GAAGTTCAAG	AACTTTACTC
68	21549	427	21481	CTGTTCTCTA	AACGAACTTT	TCTTGTTAAC	AACTAAACGA
68	27043	360	26975	CTGTTCTCTA	AACGAACTTT	CTACATCACG	AACGCTTTCT
68	27762	338	27694	CTGTTCTCTA	AACGAACTTT	AGAATGATTG	AACTTTCATT
68	25424	258	25356	CTGTTCTCTA	AACGAACTTT	TCACAATTGG	AACTGTAACT
68	26235	230	26167	CTGTTCTCTA	AACGAACTTT	AGCTGATGAG	TACGAACTTA
68	26289	188	26221	CTGTTCTCTA	AACGAACTTT	AATAGTTAAT	AGCGTACTTC
68	5788	178	5720	CTGTTCTCTA	AACGAACTTT	TATAACTTCT	AAAGAAACTT
68	18050	175	17982	CTGTTCTCTA	AACGAACTTT	CTGAAAATGT	AACAGGACTC
68	28994	158	28926	CTGTTCTCTA	AACGAACTTT	GGCCAACAAC	AACAAGGCCA
68	27866	153	27798	CTGTTCTCTA	AACGAACTTT	GCAAGATCAT	AATGAAACTT
68	23364	133	23296	CTGTTCTCTA	AACGAACTTT	TAACACCAGG	AACAAATACT
68	25490	133	25422	CTGTTCTCTA	AACGAACTTT	GCGCTACTGC	AACGATACCG
68	27473	133	27405	CTGTTCTCTA	AACGAACTTT	TTAGAGGTAC	AACAGTACTT
68	4579	113	4511	CTGTTCTCTA	AACGAACTTT	CAACACACTT	AACGATCTAA
68	27039	105	26971	CTGTTCTCTA	AACGAACTTT	GTTGCTACAT	CACGAACGCT
69	26236	149744	26167	TGTTCTCTAA	ACGAACTTTA	GCTGATGAGT	ACGAACTTAT
69	27040	38086	26971	TGTTCTCTAA	ACGAACTTTA	TTGCTACATC	ACGAACGCTT
69	27673	3866	27604	TGTTCTCTAA	ACGAACTTTA	GAGGAAGTTC	AAGAACTTTA
69	24890	553	24821	TGTTCTCTAA	ACGAACTTTA	AGGAATTTTT	ATGAACCACA
69	18940	360	18871	TGTTCTCTAA	ACGAACTTTA	ATAATTGGTG	ATGAACTGAA
69	29165	345	29096	TGTTCTCTAA	ACGAACTTTA	GGAACTGATT	ACAAACATTG
69	23027	263	22958	TGTTCTCTAA	ACGAACTTTA	TTTAATTGTT	ACTTTCCTTT
69	19570	256	19501	TGTTCTCTAA	ACGAACTTTA	TTGTGGGTTT	ACAAACAATT
69	19111	185	19042	TGTTCTCTAA	ACGAACTTTA	CCTTGTAGTG	ACAAAGCTTA
69	28164	184	28095	TGTTCTCTAA	ACGAACTTTA	ATTAATTGCC	AGGAACCTAA
69	28206	151	28137	TGTTCTCTAA	ACGAACTTTA	TGTTCGTTCT	ATGAAGACTT
69	22558	144	22489	TGTTCTCTAA	ACGAACTTTA	TCCTAATATT	ACAAACTTGT
69	27758	135	27689	TGTTCTCTAA	ACGAACTTTA	AGACAGAATG	ATTGAACTTT
69	29590	126	29521	TGTTCTCTAA	ACGAACTTTA	TTTTCCGTTT	ACGATATATA
69	5591	118	5522	TGTTCTCTAA	ACGAACTTTA	ACACTTTCTT	ATGAACAATT
69	23927	115	23858	TGTTCTCTAA	ACGAACTTTA	AAACAAATTT	ACAAAACACC
69	29351	114	29282	TGTTCTCTAA	ACGAACTTTA	ATTGACGCAT	ACAAAACATT
69	28548	114	28479	TGTTCTCTAA	ACGAACTTTA	GAGCTACCAG	ACGAATTCGT
69	24897	101	24828	TGTTCTCTAA	ACGAACTTTA	TTTATGAACC	ACAAATCATT
70	27760	5982	27690	GTTCTCTAAA	CGAACTTTAA	ACAGAATGAT	TGAACTTTCA
70	22944	703	22874	GTTCTCTAAA	CGAACTTTAA	AGTCTAATCT	CAAACCTTTT
70	22276	699	22206	GTTCTCTAAA	CGAACTTTAA	CACTAGGTTT	CAAACTTTAC
70	22501	580	22431	GTTCTCTAAA	CGAACTTTAA	AGGAATCTAT	CAAACTTCTA
70	29002	514	28932	GTTCTCTAAA	CGAACTTTAA	ACAACAAGGC	CAAACTGTCA
70	21305	396	21235	GTTCTCTAAA	CGAACTTTAA	GCAAACCACG	CGAACAAATA
70	20315	250	20245	GTTCTCTAAA	CGAACTTTAA	GCTATGCCTT	CGAACATATC
70	14371	218	14301	GTTCTCTAAA	CGAACTTTAA	CTGCATTGTG	CAAACTTTAA
70	2793	217	2723	GTTCTCTAAA	CGAACTTTAA	ATATCACTTT	TGAACTTGAT
70	24314	119	24244	GTTCTCTAAA	CGAACTTTAA	GTTCTCTATG	AGAACCAAAA
71	27761	8568	27690	TTCTCTAAAC	GAACTTTAAA	CAGAATGATT	GAACTTTCAT
71	27675	573	27604	TTCTCTAAAC	GAACTTTAAA	GGAAGTTCAA	GAACTTTACT
71	26505	489	26434	TTCTCTAAAC	GAACTTTAAA	TTTCTGTTTG	GAACTTTAAT
71	24892	137	24821	TTCTCTAAAC	GAACTTTAAA	GAATTTTTAT	GAACCACAAA
72	21546	290	21474	TCTCTAAACG	AACTTTAAAA	TGTTCTTGTT	AACAACTAAA
72	28570	146	28498	TCTCTAAACG	AACTTTAAAA	TGGTGACGGT	AAAATGAAAG
73	23027	210	22954	CTCTAAACGA	ACTTTAAAAT	TTTAATTGTT	ACTTTCCTTT
73	27777	134	27704	CTCTAAACGA	ACTTTAAAAT	TCATTAATTG	ACTTCTATTT
73	27682	103	27609	CTCTAAACGA	ACTTTAAAAT	CAAGAACTTT	ACTCTCCAAT
73	22381	100	22308	CTCTAAACGA	ACTTTAAAAT	TCAACCTAGG	ACTTTTCTAT
74	21057	990	20983	TCTAAACGAA	CTTTAAAATC	TATGTACGAC	CCTAAGACTA
74	21552	843	21478	TCTAAACGAA	CTTTAAAATC	TGTTAACAAC	TAAACGAACA
74	28265	175	28191	TCTAAACGAA	CTTTAAAATC	CTAAACGAAC	AAACTAAAAT
74	28891	128	28817	TCTAAACGAA	CTTTAAAATC	GGGAACTTCT	CCTGCTAGAA
74	21561	117	21487	TCTAAACGAA	CTTTAAAATC	CTAAACGAAC	AATGTTTGTT
75	28964	622	28889	CTAAACGAAC	TTTAAAATCT	AACCAGCTTG	AGAGCAAAAT
75	26485	409	26410	CTAAACGAAC	TTTAAAATCT	AACTAAATAT	TATATTAGTT
75	27798	255	27723	CTAAACGAAC	TTTAAAATCT	TGCTTTTTAG	CCTTTCTGCT
75	28267	144	28192	CTAAACGAAC	TTTAAAATCT	AAACGAACAA	ACTAAAATGT
76	28266	9868	28190	TAAACGAACT	TTAAAATCTG	TAAACGAACA	AACTAAAATG
76	21562	992	21486	TAAACGAACT	TTAAAATCTG	TAAACGAACA	ATGTTTGTTT
76	27394	950	27318	TAAACGAACT	TTAAAATCTG	TAAACGAACA	TGAAAATTAT
76	26482	115	26406	TAAACGAACT	TTAAAATCTG	ACGAACTAAA	TATTATATTA
76	27894	105	27818	TAAACGAACT	TTAAAATCTG	TAAACGAACA	TGAAATTTCT
77	26271	258	26194	AAACGAACTT	TAAAATCTGT	GGAAGAGACA	GGTACGTTAA
77	26480	212	26403	AAACGAACTT	TAAAATCTGT	AAACGAACTA	AATATTATAT
78	25393	355	25315	AACGAACTTT	AAAATCTGTG	AACGAACTTA	TGGATTTGTT
78	27754	136	27676	AACGAACTTT	AAAATCTGTG	AGAAAGACAG	AATGATTGAA
82	26276	669	26194	AACTTTAAAA	TCTGTGTGGC	AGACAGGTAC	GTTAATAGTT
83	21562	863	21479	ACTTTAAAAT	CTGTGTGGCT	TAAACGAACA	ATGTTTGTTT
83	26250	183	26167	ACTTTAAAAT	CTGTGTGGCT	ACTTATGTAC	TCATTCGTTT
289	28258	138	27969	CCCTGGTTTC	AACGAGAAAA	ATTTCATCTA	AACGAACAAA
297	28262	101	27965	TCAACGAGAA	AACACACGTC	CATCTAAACG	AACAAACTAA
731	29306	190	28575	CCTTATGAAG	ATTTTCAAGA	AAAGATCCAA	ATTTCAAAGA
755	29309	135	28554	TGGAACACTA	AACATAGCAG	GATCCAAATT	TCAAAGATCA
827	29309	180	28482	TATGTCGATA	ACAACTTCTG	GATCCAAATT	TCAAAGATCA
929	29309	140	28380	CTGGACTTTA	TTGACACTAA	GATCCAAATT	TCAAAGATCA
1025	28697	108	27672	TTGCAGACAC	CTTTTGAAAT	TTGAATACAC	CAAAAGATCA
1073	29300	246	28227	AATGGGGAAT	GTCCAAATTT	GATGACAAAG	ATCCAAATTT
1210	1273	113	63	CAACCAAATG	TGCCTTTCAA	GGGCGATTTT	GTTAAAGCCA
1273	29338	107	28065	GGGCGATTTT	GTTAAAGCCA	GCTGAATAAG	CATATTGACG
1289	29305	152	28016	GCCACTTGCG	AATTTTGTGG	CAAAGATCCA	AATTTCAAAG
1293	29352	107	28059	CTTGCGAATT	TTGTGGCACT	TTGACGCATA	CAAAACATTC
1361	29307	124	27946	AATGCTGTTG	TTAAAATTTA	AAGATCCAAA	TTTCAAAGAT
1426	29348	144	27922	TGCCGAATAC	CATAATGAAT	CATATTGACG	CATACAAAAC
1430	29309	120	27879	GAATACCATA	ATGAATCTGG	GATCCAAATT	TCAAAGATCA
1470	29064	105	27594	AGGGTGGTCG	CACTATTGCC	AACGTACTGC	CACTAAAGCA
1473	29334	100	27861	GTGGTCGCAC	TATTGCCTTT	TTTTGCTGAA	TAAGCATATT
1475	29309	224	27834	GGTCGCACTA	TTGCCTTTGG	GATCCAAATT	TCAAAGATCA
1475	29493	182	28018	GGTCGCACTA	TTGCCTTTGG	CCAAACAATT	GCAACAATCC
1475	29480	117	28005	GGTCGCACTA	TTGCCTTTGG	TTGGATGATT	TCTCCAAACA
1479	29087	112	27608	GCACTATTGC	CTTTGGAGGC	AATGTAACAC	AAGCTTTCGG
1513	29348	222	27835	TGTTGGTTGC	CATAACAAGT	CATATTGACG	CATACAAAAC
1515	29067	129	27552	TTGGTTGCCA	TAACAAGTGT	GTACTGCCAC	TAAAGCATAC
1515	29081	111	27566	TTGGTTGCCA	TAACAAGTGT	GCATACAATG	TAACACAAGC
1517	29480	169	27963	GGTTGCCATA	ACAAGTGTGC	TTGGATGATT	TCTCCAAACA
1517	29493	133	27976	GGTTGCCATA	ACAAGTGTGC	CCAAACAATT	GCAACAATCC
1523	29315	337	27792	CATAACAAGT	GTGCCTATTG	AATTTCAAAG	ATCAAGTCAT
1613	28684	144	27071	AATGACAACC	TTCTTGAAAT	AACTGAGGGA	GCCTTGAATA
1620	28690	256	27070	ACCTTCTTGA	AATACTCCAA	GGGAGCCTTG	AATACACCAA
1624	28695	177	27071	TCTTGAAATA	CTCCAAAAAG	CCTTGAATAC	ACCAAAAGAT
1652	29309	126	27657	AACATCAATA	TTGTTGGTGA	GATCCAAATT	TCAAAGATCA
1670	29307	103	27637	GACTTTAAAC	TTAATGAAGA	AAGATCCAAA	TTTCAAAGAT
1673	29309	179	27636	TTTAAACTTA	ATGAAGAGAT	GATCCAAATT	TCAAAGATCA
1673	29493	105	27820	TTTAAACTTA	ATGAAGAGAT	CCAAACAATT	GCAACAATCC
1852	29268	185	27416	GAAATCAATA	CTGAGTCCTC	CGTGGTTGAC	CTACACAGGT
1852	28255	140	26403	GAAATCAATA	CTGAGTCCTC	TAGATTTCAT	CTAAACGAAC
1853	29475	1013	27622	AAATCAATAC	TGAGTCCTCT	CAGATTTGGA	TGATTTCTCC
1853	29478	342	27625	AAATCAATAC	TGAGTCCTCT	ATTTGGATGA	TTTCTCCAAA
1853	29325	272	27472	AAATCAATAC	TGAGTCCTCT	ATCAAGTCAT	TTTGCTGAAT
1853	29343	241	27490	AAATCAATAC	TGAGTCCTCT	ATAAGCATAT	TGACGCATAC
1853	29342	201	27489	AAATCAATAC	TGAGTCCTCT	AATAAGCATA	TTGACGCATA
1853	29264	196	27411	AAATCAATAC	TGAGTCCTCT	GGAACGTGGT	TGACCTACAC
1853	29479	169	27626	AAATCAATAC	TGAGTCCTCT	TTTGGATGAT	TTCTCCAAAC
1853	29324	165	27471	AAATCAATAC	TGAGTCCTCT	GATCAAGTCA	TTTTGCTGAA
1853	29307	152	27454	AAATCAATAC	TGAGTCCTCT	AAGATCCAAA	TTTCAAAGAT
1853	29183	143	27330	AAATCAATAC	TGAGTCCTCT	TGGCCGCAAA	TTGCACAATT
1853	29193	142	27340	AAATCAATAC	TGAGTCCTCT	TTGCACAATT	TGCCCCCAGC
1853	29334	129	27481	AAATCAATAC	TGAGTCCTCT	TTTTGCTGAA	TAAGCATATT
1853	28600	125	26747	AAATCAATAC	TGAGTCCTCT	AAGATGGTAT	TTCTACTACC
1853	29163	125	27310	AAATCAATAC	TGAGTCCTCT	AAGGAACTGA	TTACAAACAT
1853	29308	122	27455	AAATCAATAC	TGAGTCCTCT	AGATCCAAAT	TTCAAAGATC
1853	28688	111	26835	AAATCAATAC	TGAGTCCTCT	GAGGGAGCCT	TGAATACACC
1853	29292	108	27439	AAATCAATAC	TGAGTCCTCT	TCAAATTGGA	TGACAAAGAT
1853	29192	107	27339	AAATCAATAC	TGAGTCCTCT	ATTGCACAAT	TTGCCCCCAG
1853	29480	101	27627	AAATCAATAC	TGAGTCCTCT	TTGGATGATT	TCTCCAAACA
1859	29087	281	27228	ATACTGAGTC	CTCTTTATGC	AATGTAACAC	AAGCTTTCGG
1859	29409	110	27550	ATACTGAGTC	CTCTTTATGC	CTGATGAAAC	TCAAGCCTTA
1859	29085	106	27226	ATACTGAGTC	CTCTTTATGC	ACAATGTAAC	ACAAGCTTTC
1862	29324	105	27462	CTGAGTCCTC	TTTATGCATT	GATCAAGTCA	TTTTGCTGAA
1946	29307	101	27361	TCTGTGCGTG	TTTTACAGAA	AAGATCCAAA	TTTCAAAGAT
1988	29476	648	27488	GGAATTTCAC	AGTATTCACT	AGATTTGGAT	GATTTCTCCA
1988	29479	395	27491	GGAATTTCAC	AGTATTCACT	TTTGGATGAT	TTCTCCAAAC
1988	29326	293	27338	GGAATTTCAC	AGTATTCACT	TCAAGTCATT	TTGCTGAATA
1988	29344	178	27356	GGAATTTCAC	AGTATTCACT	TAAGCATATT	GACGCATACA
1988	29308	139	27320	GGAATTTCAC	AGTATTCACT	AGATCCAAAT	TTCAAAGATC
1988	29082	132	27094	GGAATTTCAC	AGTATTCACT	CATACAATGT	AACACAAGCT
1988	29327	129	27339	GGAATTTCAC	AGTATTCACT	CAAGTCATTT	TGCTGAATAA
1988	29480	124	27492	GGAATTTCAC	AGTATTCACT	TTGGATGATT	TCTCCAAACA
1988	29165	104	27177	GGAATTTCAC	AGTATTCACT	GGAACTGATT	ACAAACATTG
1988	29404	104	27416	GGAATTTCAC	AGTATTCACT	GAAGGCTGAT	GAAACTCAAG
1988	29309	101	27321	GGAATTTCAC	AGTATTCACT	GATCCAAATT	TCAAAGATCA
1988	29194	100	27206	GGAATTTCAC	AGTATTCACT	TGCACAATTT	GCCCCCAGCG
2032	29307	138	27275	CACATCTGAT	TTGGCTACTA	AAGATCCAAA	TTTCAAAGAT
2033	29475	135	27442	ACATCTGATT	TGGCTACTAA	CAGATTTGGA	TGATTTCTCC
2150	29306	166	27156	CCCGTCCTTG	ATTGGCTTGA	AAAGATCCAA	ATTTCAAAGA
2464	29309	126	26845	CATGCCTCTA	AAAGCCCCAA	GATCCAAATT	TCAAAGATCA
2477	29304	112	26827	GCCCCAAAAG	AAATTATCTT	ACAAAGATCC	AAATTTCAAA
2479	29477	130	26998	CCCAAAAGAA	ATTATCTTCT	GATTTGGATG	ATTTCTCCAA
2483	29309	225	26826	AAAGAAATTA	TCTTCTTAGA	GATCCAAATT	TCAAAGATCA
2484	29353	110	26869	AAGAAATTAT	CTTCTTAGAG	TGACGCATAC	AAAACATTCC
2678	29309	108	26631	CTTGCACCTA	ATATGATGGT	GATCCAAATT	TCAAAGATCA
3023	29309	169	26286	GCTTCACATA	TGTATTGTTC	GATCCAAATT	TCAAAGATCA
3027	29309	126	26282	CACATATGTA	TTGTTCTTTC	GATCCAAATT	TCAAAGATCA
3033	29325	114	26292	TGTATTGTTC	TTTCTACCCT	ATCAAGTCAT	TTTGCTGAAT
3413	29309	113	25896	GAAGAAGCTA	AAAAGGTAAA	GATCCAAATT	TCAAAGATCA
4172	4238	127	66	GTTATACCTA	CTAAAAAGGC	ACAGACAATT	ATATAACCAC
4175	4238	274	63	ATACCTACTA	AAAAGGCTGG	ACAGACAATT	ATATAACCAC
4194	4214	123	20	GTGGCACTAC	TGAAATGCTA	GCGAAAGCTT	TGAGAAAAGT
6586	29352	156	22766	TCTTACTATT	AAGAAACCTA	TTGACGCATA	CAAAACATTC
6599	29305	104	22706	AAACCTAATG	AATTATCTAG	CAAAGATCCA	AATTTCAAAG
6629	29307	141	22678	TTGAAAACCC	TTGCTACTCA	AAGATCCAAA	TTTCAAAGAT
6653	29342	163	22689	TTAGCTGCTG	TTAATAGTGT	AATAAGCATA	TTGACGCATA
6659	29315	233	22656	GCTGTTAATA	GTGTCCCTTG	AATTTCAAAG	ATCAAGTCAT
6807	29324	305	22517	AATTGTGTAC	TTTTACTAGA	GATCAAGTCA	TTTTGCTGAA
6807	29325	140	22518	AATTGTGTAC	TTTTACTAGA	ATCAAGTCAT	TTTGCTGAAT
6808	29324	231	22516	ATTGTGTACT	TTTACTAGAA	GATCAAGTCA	TTTTGCTGAA
6808	29478	143	22670	ATTGTGTACT	TTTACTAGAA	ATTTGGATGA	TTTCTCCAAA
6808	29475	113	22667	ATTGTGTACT	TTTACTAGAA	CAGATTTGGA	TGATTTCTCC
6809	29475	162	22666	TTGTGTACTT	TTACTAGAAG	CAGATTTGGA	TGATTTCTCC
6809	29324	141	22515	TTGTGTACTT	TTACTAGAAG	GATCAAGTCA	TTTTGCTGAA
6809	29478	115	22669	TTGTGTACTT	TTACTAGAAG	ATTTGGATGA	TTTCTCCAAA
6938	29157	111	22219	AATTTTTCTA	AACTGATAAA	TCAGACAAGG	AACTGATTAC
6947	29474	114	22527	AAACTGATAA	ATATTATAAT	GCAGATTTGG	ATGATTTCTC
6950	29325	115	22375	CTGATAAATA	TTATAATTTG	ATCAAGTCAT	TTTGCTGAAT
6951	29475	148	22524	TGATAAATAT	TATAATTTGG	CAGATTTGGA	TGATTTCTCC
6952	29474	132	22522	GATAAATATT	ATAATTTGGT	GCAGATTTGG	ATGATTTCTC
6964	29324	117	22360	AATTTGGTTT	TTACTATTAA	GATCAAGTCA	TTTTGCTGAA
6979	29475	126	22496	ATTAAGTGTT	TGCCTAGGTT	CAGATTTGGA	TGATTTCTCC
7205	29324	122	22119	ATTTCATCTT	TTAAATGGGA	GATCAAGTCA	TTTTGCTGAA
21569	27807	656	6238	ACAATGTTTG	TTTTTCTTGT	GCCTTTCTGC	TATTCCTTGT
21571	27809	669	6238	AATGTTTGTT	TTTCTTGTTT	CTTTCTGCTA	TTCCTTGTTT
21740	21779	4145	39	CCTTTCTTTT	CCAATGTTAC	GTCTCTGGGA	CCAATGGTAC
22824	22902	1168	78	TTGCTGATTA	TAATTATAAA	AGGTTGGTGG	TAATTATAAT
22830	22902	167	72	ATTATAATTA	TAAATTACCA	AGGTTGGTGG	TAATTATAAT
23432	23508	129	76	CCTGTTGCTA	TTCATGCAGA	GTGCAGGCTG	TTTAATAGGG
23432	23510	120	78	CCTGTTGCTA	TTCATGCAGA	GCAGGCTGTT	TAATAGGGGC
23469	23489	208	20	GGCGTGTTTA	TTCTACAGGT	TCTAATGTTT	TTCAAACACG
23554	23582	398	28	GTGTGACATA	CCCATTGGTG	TGCGCTAGTT	ATCAGACTCA
23558	23580	159	22	GACATACCCA	TTGGTGCAGG	TATGCGCTAG	TTATCAGACT
24082	24149	607	67	TGGTGATTGC	CTTGGTGATA	GTTTTGCCAC	CTTTGCTCAC
24812	24847	113	35	ATTTGTCATG	ATGGAAAAGC	AGGTGTCTTT	GTTTCAAATG
25397	26276	457	879	AACTTATGGA	TTTGTTTATG	AGACAGGTAC	GTTAATAGTT
25480	25548	111	68	GATTTTGTTC	GCGCTACTGC	CGTTGCACTT	CTTGCTGTTT
25503	25533	106	30	GATACCGATA	CAAGCCTCAC	ATGGCTTATT	GTTGGCGTTG
25531	25556	134	25	GGATGGCTTA	TTGTTGGCGT	TTCTTGCTGT	TTTTCAGAGC
25531	25557	114	26	GGATGGCTTA	TTGTTGGCGT	TCTTGCTGTT	TTTCAGAGCG
25641	25671	111	30	TTGCAACTTG	CTGTTGTTGT	TTACTCACAC	CTTTTGCTCG
25644	25672	488	28	CAACTTGCTG	TTGTTGTTTG	TACTCACACC	TTTTGCTCGT
26017	26053	123	36	TACTTCACTT	CAGACTATTA	CAATTGAGTA	CAGACACTGG
26249	26276	11161	27	AACTTATGTA	CTCATTCGTT	AGACAGGTAC	GTTAATAGTT
26252	26279	474	27	TTATGTACTC	ATTCGTTTCG	CAGGTACGTT	AATAGTTAAT
26253	27766	118	1513	TATGTACTCA	TTCGTTTCGG	TGATTGAACT	TTCATTAATT
26254	26281	917	27	ATGTACTCAT	TCGTTTCGGA	GGTACGTTAA	TAGTTAATAG
26256	26283	800532	27	GTACTCATTC	GTTTCGGAAG	TACGTTAATA	GTTAATAGCG
26260	26287	499	27	TCATTCGTTT	CGGAAGAGAC	TTAATAGTTA	ATAGCGTACT
26272	26914	120	642	GAAGAGACAG	GTACGTTAAT	TTCTGACCAG	ACCGCTTCTA
26487	27792	1762	1305	CTAAATATTA	TATTAGTTTT	TATTTGTGCT	TTTTAGCCTT
26489	27794	1768	1305	AAATATTATA	TTAGTTTTTC	TTTGTGCTTT	TTAGCCTTTC
26489	29575	201	3086	AAATATTATA	TTAGTTTTTC	TATAAACGTT	TTCGCTTTTC
26489	26672	124	183	AAATATTATA	TTAGTTTTTC	TATAATTAAG	TTAATTTTCC
26514	27792	115	1278	GGAACTTTAA	TTTTAGCCAT	TATTTGTGCT	TTTTAGCCTT
26573	26603	263	30	AAAGCTCCTT	GAACAATGGA	AGGTTTCCTA	TTCCTTACAT
26574	26603	316	29	AAGCTCCTTG	AACAATGGAA	AGGTTTCCTA	TTCCTTACAT
26772	26826	271	54	GCTATCGCAA	TGGCTTGTCT	TCTTTCAGAC	TGTTTGCGCG
26774	26830	3173	56	TATCGCAATG	GCTTGTCTTG	TCAGACTGTT	TGCGCGTACG
26774	26831	1514	57	TATCGCAATG	GCTTGTCTTG	CAGACTGTTT	GCGCGTACGC
26775	26817	1459	42	ATCGCAATGG	CTTGTCTTGT	TTCATTGCTT	CTTTCAGACT
26776	26828	925	52	TCGCAATGGC	TTGTCTTGTA	TTTCAGACTG	TTTGCGCGTA
26776	26829	389	53	TCGCAATGGC	TTGTCTTGTA	TTCAGACTGT	TTGCGCGTAC
26776	26819	100	43	TCGCAATGGC	TTGTCTTGTA	CATTGCTTCT	TTCAGACTGT
26778	26824	528	46	GCAATGGCTT	GTCTTGTAGG	CTTCTTTCAG	ACTGTTTGCG
26778	26828	260	50	GCAATGGCTT	GTCTTGTAGG	TTTCAGACTG	TTTGCGCGTA
26779	26816	7492	37	CAATGGCTTG	TCTTGTAGGC	CTTCATTGCT	TCTTTCAGAC
26781	26819	483	38	ATGGCTTGTC	TTGTAGGCTT	CATTGCTTCT	TTCAGACTGT
26781	26828	256	47	ATGGCTTGTC	TTGTAGGCTT	TTTCAGACTG	TTTGCGCGTA
26781	26829	134	48	ATGGCTTGTC	TTGTAGGCTT	TTCAGACTGT	TTGCGCGTAC
26783	26824	485	41	GGCTTGTCTT	GTAGGCTTGA	CTTCTTTCAG	ACTGTTTGCG
26784	26820	4839	36	GCTTGTCTTG	TAGGCTTGAT	ATTGCTTCTT	TCAGACTGTT
26784	26821	236	37	GCTTGTCTTG	TAGGCTTGAT	TTGCTTCTTT	CAGACTGTTT
26786	26820	6663	34	TTGTCTTGTA	GGCTTGATGT	ATTGCTTCTT	TCAGACTGTT
26786	26821	390	35	TTGTCTTGTA	GGCTTGATGT	TTGCTTCTTT	CAGACTGTTT
26786	26830	130	44	TTGTCTTGTA	GGCTTGATGT	TCAGACTGTT	TGCGCGTACG
26934	26968	108	34	GAAAGTGAAC	TCGTAATCGG	GTGGACATCT	TCGTATTGCT
26939	26975	374	36	TGAACTCGTA	ATCGGAGCTG	TCTTCGTATT	GCTGGACACC
27087	27915	137	828	CGTGTAGCAG	GTGACTCAGG	GTTTTCTTAG	GAATCATCAC
27187	27225	249	38	TGCTTGTACA	GTAAGTGACA	TGACTTTCAG	GTTACTATAG
27190	27221	778	31	TTGTACAGTA	AGTGACAACA	TCGTTGACTT	TCAGGTTACT
27194	27221	269	27	ACAGTAAGTG	ACAACAGATG	TCGTTGACTT	TCAGGTTACT
27207	27235	203	28	ACAGATGTTT	CATCTCGTTG	GTTACTATAG	CAGAGATATT
27213	27631	176	418	GTTTCATCTC	GTTGACTTTC	TTACGTGCCA	GATCAGTTTC
27230	27291	127	61	TTCAGGTTAC	TATAGCAGAG	GAATCTTGAT	TACATCATAA
27247	27307	447	60	GAGATATTAC	TAATTATTAT	ATAAACCTCA	TAATTAAAAA
27262	27285	210	23	ATTATGAGGA	CTTTTAAAGT	CATTTGGAAT	CTTGATTACA
27263	27290	2463	27	TTATGAGGAC	TTTTAAAGTT	GGAATCTTGA	TTACATCATA
27264	27290	1010	26	TATGAGGACT	TTTAAAGTTT	GGAATCTTGA	TTACATCATA
27265	27300	507	35	ATGAGGACTT	TTAAAGTTTC	TTACATCATA	AACCTCATAA
27265	27293	488	28	ATGAGGACTT	TTAAAGTTTC	ATCTTGATTA	CATCATAAAC
27265	27290	342	25	ATGAGGACTT	TTAAAGTTTC	GGAATCTTGA	TTACATCATA
27265	27325	341	60	ATGAGGACTT	TTAAAGTTTC	AATTTATCTA	AGTCACTAAC
27265	27289	101	24	ATGAGGACTT	TTAAAGTTTC	TGGAATCTTG	ATTACATCAT
27266	27300	347	34	TGAGGACTTT	TAAAGTTTCC	TTACATCATA	AACCTCATAA
27266	27293	178	27	TGAGGACTTT	TAAAGTTTCC	ATCTTGATTA	CATCATAAAC
27268	27292	115	24	AGGACTTTTA	AAGTTTCCAT	AATCTTGATT	ACATCATAAA
27331	27355	153	24	TCTAAGTCAC	TAACTGAGAA	TATTCTCAAT	TAGATGAAGA
27366	27682	224	316	AGATGAAGAG	CAACCAATGG	CAAGAACTTT	ACTCTCCAAT
27379	29470	117	2091	CCAATGGAGA	TTGATTAAAC	TGCTGCAGAT	TTGGATGATT
27380	29475	101	2095	CAATGGAGAT	TGATTAAACG	CAGATTTGGA	TGATTTCTCC
27381	27945	170	564	AATGGAGATT	GATTAAACGA	GCATTTCACC	AAGAATGTAG
27381	29467	164	2086	AATGGAGATT	GATTAAACGA	TCCTGCTGCA	GATTTGGATG
27383	29470	319	2087	TGGAGATTGA	TTAAACGAAC	TGCTGCAGAT	TTGGATGATT
27384	28256	216	872	GGAGATTGAT	TAAACGAACA	AGATTTCATC	TAAACGAACA
27384	27884	144	500	GGAGATTGAT	TAAACGAACA	TTGTCACGCC	TAAACGAACA
27385	29477	172	2092	GAGATTGATT	AAACGAACAT	GATTTGGATG	ATTTCTCCAA
27385	29474	167	2089	GAGATTGATT	AAACGAACAT	GCAGATTTGG	ATGATTTCTC
27386	29472	462	2086	AGATTGATTA	AACGAACATG	CTGCAGATTT	GGATGATTTC
27386	29471	358	2085	AGATTGATTA	AACGAACATG	GCTGCAGATT	TGGATGATTT
27386	29477	155	2091	AGATTGATTA	AACGAACATG	GATTTGGATG	ATTTCTCCAA
27386	29473	125	2087	AGATTGATTA	AACGAACATG	TGCAGATTTG	GATGATTTCT
27389	27761	180	372	TTGATTAAAC	GAACATGAAA	CAGAATGATT	GAACTTTCAT
27396	27696	103	300	AACGAACATG	AAAATTATTC	TCCAATTTTT	CTTATTGTTG
27400	27463	188	63	AACATGAAAA	TTATTCTTTT	CAAGAGTGTG	TTAGAGGTAC
27402	27461	125	59	CATGAAAATT	ATTCTTTTCT	ACCAAGAGTG	TGTTAGAGGT
27402	27463	115	61	CATGAAAATT	ATTCTTTTCT	CAAGAGTGTG	TTAGAGGTAC
27403	27463	155	60	ATGAAAATTA	TTCTTTTCTT	CAAGAGTGTG	TTAGAGGTAC
27403	27465	103	62	ATGAAAATTA	TTCTTTTCTT	AGAGTGTGTT	AGAGGTACAA
27547	27746	188	199	CTAGCTGATA	ACAAATTTGC	CACTCAAAAG	AAAGACAGAA
27552	27621	478	69	TGATAACAAA	TTTGCACTGA	CGTCTATCAG	TTACGTGCCA
27553	27621	265	68	GATAACAAAT	TTGCACTGAC	CGTCTATCAG	TTACGTGCCA
27554	27646	1193	92	ATAACAAATT	TGCACTGACT	GTTTCACCTA	AACTGTTCAT
27554	27579	279	25	ATAACAAATT	TGCACTGACT	TAGCACTCAA	TTTGCTTTTG
27558	27643	414	85	CAAATTTGCA	CTGACTTGCT	TCAGTTTCAC	CTAAACTGTT
27558	27649	183	91	CAAATTTGCA	CTGACTTGCT	TCACCTAAAC	TGTTCATCAG
27578	27758	181	180	TTAGCACTCA	ATTTGCTTTT	AGACAGAATG	ATTGAACTTT
27578	27623	100	45	TTAGCACTCA	ATTTGCTTTT	TCTATCAGTT	ACGTGCCAGA
27598	27623	188	25	GCTTGTCCTG	ACGGCGTAAA	TCTATCAGTT	ACGTGCCAGA
27605	27964	122	359	CTGACGGCGT	AAAACACGTC	GTTTACAGTC	ATGTACTCAA
27615	27639	102	24	AAAACACGTC	TATCAGTTAC	CAGATCAGTT	TCACCTAAAC
27682	27754	3520	72	CAAGAACTTT	ACTCTCCAAT	AGAAAGACAG	AATGATTGAA
27682	27758	118	76	CAAGAACTTT	ACTCTCCAAT	AGACAGAATG	ATTGAACTTT
27684	29350	107	1666	AGAACTTTAC	TCTCCAATTT	TATTGACGCA	TACAAAACAT
27685	29279	162	1594	GAACTTTACT	CTCCAATTTT	TACACAGGTG	CCATCAAATT
27693	27721	210	28	CTCTCCAATT	TTTCTTATTG	ATAGTGTTTA	TAACACTTTG
27749	29278	117	1529	TCAAAAGAAA	GACAGAATGA	CTACACAGGT	GCCATCAAAT
27761	27864	130	103	CAGAATGATT	GAACTTTCAT	CTGCAAGATC	ATAATGAAAC
27765	29307	101	1542	ATGATTGAAC	TTTCATTAAT	AAGATCCAAA	TTTCAAAGAT
27769	29306	249	1537	TTGAACTTTC	ATTAATTGAC	AAAGATCCAA	ATTTCAAAGA
27769	29190	243	1421	TTGAACTTTC	ATTAATTGAC	AAATTGCACA	ATTTGCCCCC
27771	28195	177	424	GAACTTTCAT	TAATTGACTT	TTGTAGTGCG	TTGTTCGTTC
27773	29193	458	1420	ACTTTCATTA	ATTGACTTCT	TTGCACAATT	TGCCCCCAGC
27773	29309	426	1536	ACTTTCATTA	ATTGACTTCT	GATCCAAATT	TCAAAGATCA
27773	29194	194	1421	ACTTTCATTA	ATTGACTTCT	TGCACAATTT	GCCCCCAGCG
27773	29289	140	1516	ACTTTCATTA	ATTGACTTCT	CCATCAAATT	GGATGACAAA
27783	29190	1591	1407	ATTGACTTCT	ATTTGTGCTT	AAATTGCACA	ATTTGCCCCC
27783	29230	158	1447	ATTGACTTCT	ATTTGTGCTT	AATGTCGCGC	ATTGGCATGG
27784	29192	501	1408	TTGACTTCTA	TTTGTGCTTT	ATTGCACAAT	TTGCCCCCAG
27784	29193	473	1409	TTGACTTCTA	TTTGTGCTTT	TTGCACAATT	TGCCCCCAGC
27784	29194	318	1410	TTGACTTCTA	TTTGTGCTTT	TGCACAATTT	GCCCCCAGCG
27784	29233	127	1449	TTGACTTCTA	TTTGTGCTTT	GTCGCGCATT	GGCATGGAAG
27785	29191	124	1406	TGACTTCTAT	TTGTGCTTTT	AATTGCACAA	TTTGCCCCCA
27791	29191	184	1400	CTATTTGTGC	TTTTTAGCCT	AATTGCACAA	TTTGCCCCCA
27792	29172	376	1380	TATTTGTGCT	TTTTAGCCTT	ATTACAAACA	TTGGCCGCAA
27792	29191	233	1399	TATTTGTGCT	TTTTAGCCTT	AATTGCACAA	TTTGCCCCCA
27792	29163	214	1371	TATTTGTGCT	TTTTAGCCTT	AAGGAACTGA	TTACAAACAT
27793	29172	246	1379	ATTTGTGCTT	TTTAGCCTTT	ATTACAAACA	TTGGCCGCAA
27793	29191	131	1398	ATTTGTGCTT	TTTAGCCTTT	AATTGCACAA	TTTGCCCCCA
27793	29163	114	1370	ATTTGTGCTT	TTTAGCCTTT	AAGGAACTGA	TTACAAACAT
27794	29172	149	1378	TTTGTGCTTT	TTAGCCTTTC	ATTACAAACA	TTGGCCGCAA
27799	29171	792	1372	GCTTTTTAGC	CTTTCTGCTA	GATTACAAAC	ATTGGCCGCA
27800	29163	272	1363	CTTTTTAGCC	TTTCTGCTAT	AAGGAACTGA	TTACAAACAT
27800	29191	102	1391	CTTTTTAGCC	TTTCTGCTAT	AATTGCACAA	TTTGCCCCCA
27801	29172	172	1371	TTTTTAGCCT	TTCTGCTATT	ATTACAAACA	TTGGCCGCAA
27802	29175	149	1373	TTTTAGCCTT	TCTGCTATTC	ACAAACATTG	GCCGCAAATT
27811	27981	146	170	TTCTGCTATT	CCTTGTTTTA	CAACATCAAC	CATATGTAGT
27816	27836	164	20	CTATTCCTTG	TTTTAATTAT	GCTTATTATC	TTTTGGTTCT
27851	27969	294	118	GTTCTCACTT	GAACTGCAAG	CAGTCATGTA	CTCAACATCA
27877	28117	128	240	ATGAAACTTG	TCACGCCTAA	AGTACATCGA	TATCGGTAAT
27883	28255	107	372	CTTGTCACGC	CTAAACGAAC	TAGATTTCAT	CTAAACGAAC
27886	27908	26861	22	GTCACGCCTA	AACGAACATG	ATTTCTTGTT	TTCTTAGGAA
27903	28207	302	304	ATGAAATTTC	TTGTTTTCTT	GTTCGTTCTA	TGAAGACTTT
27952	28244	105	292	ACCAAGAATG	TAGTTTACAG	TCGTGTTGTT	TTAGATTTCA
28122	28248	828	126	ATCGATATCG	GTAATTATAC	GTTGTTTTAG	ATTTCATCTA
28130	28230	122	100	CGGTAATTAT	ACAGTTTCCT	GAGTATCATG	ACGTTCGTGT
28137	28162	112	25	TATACAGTTT	CCTGTTCACC	CAATTAATTG	CCAGGAACCT
28149	28233	190	84	TGTTCACCTT	TTACAATTAA	TATCATGACG	TTCGTGTTGT
28157	28242	199	85	TTTTACAATT	AATTGCCAGG	GTTCGTGTTG	TTTTAGATTT
28239	28271	119	32	GACGTTCGTG	TTGTTTTAGA	GAACAAACTA	AAATGTCTGA
28281	29144	257	863	AAATGTCTGA	TAATGGACCC	GACCAGGAAC	TAATCAGACA
28318	29122	301	804	ACCCCGCATT	ACGTTTGGTG	ACAAACCCAA	GGAAATTTTG
28318	29083	214	765	ACCCCGCATT	ACGTTTGGTG	ATACAATGTA	ACACAAGCTT
28318	29069	111	751	ACCCCGCATT	ACGTTTGGTG	ACTGCCACTA	AAGCATACAA
28320	29017	246	697	CCCGCATTAC	GTTTGGTGGA	TGTCACTAAG	AAATCTGCTG
28320	29123	156	803	CCCGCATTAC	GTTTGGTGGA	CAAACCCAAG	GAAATTTTGG
28341	29014	105	673	CCTCAGATTC	AACTGGCAGT	AACTGTCACT	AAGAAATCTG
28357	28971	141	614	CAGTAACCAG	AATGGAGAAC	TTGAGAGCAA	AATGTCTGGT
28359	28426	679	67	GTAACCAGAA	TGGAGAACGC	TACTGCGTCT	TGGTTCACCG
28361	28427	1692	66	AACCAGAATG	GAGAACGCAG	ACTGCGTCTT	GGTTCACCGC
28361	28415	1147	54	AACCAGAATG	GAGAACGCAG	TTACCCAATA	ATACTGCGTC
28361	28431	1020	70	AACCAGAATG	GAGAACGCAG	CGTCTTGGTT	CACCGCTCTC
28361	28406	137	45	AACCAGAATG	GAGAACGCAG	CCCCAAGGTT	TACCCAATAA
28361	28407	126	46	AACCAGAATG	GAGAACGCAG	CCCAAGGTTT	ACCCAATAAT
28361	28432	126	71	AACCAGAATG	GAGAACGCAG	GTCTTGGTTC	ACCGCTCTCA
28361	29015	124	654	AACCAGAATG	GAGAACGCAG	ACTGTCACTA	AGAAATCTGC
28402	28427	329	25	TCGGCCCCAA	GGTTTACCCA	ACTGCGTCTT	GGTTCACCGC
28404	28425	494	21	GGCCCCAAGG	TTTACCCAAT	ATACTGCGTC	TTGGTTCACC
28405	28425	295	20	GCCCCAAGGT	TTACCCAATA	ATACTGCGTC	TTGGTTCACC
28405	28429	201	24	GCCCCAAGGT	TTACCCAATA	TGCGTCTTGG	TTCACCGCTC
28406	28428	220	22	CCCCAAGGTT	TACCCAATAA	CTGCGTCTTG	GTTCACCGCT
28407	28428	139	21	CCCAAGGTTT	ACCCAATAAT	CTGCGTCTTG	GTTCACCGCT
28413	29013	116	600	GTTTACCCAA	TAATACTGCG	AAACTGTCAC	TAAGAAATCT
28427	28975	119	548	ACTGCGTCTT	GGTTCACCGC	GAGCAAAATG	TCTGGTAAAG
28445	28853	124	408	GCTCTCACTC	AACATGGCAA	CGCAACAGTT	CAAGAAATTC
28464	28692	286	228	AGGAAGACCT	TAAATTCCCT	GAGCCTTGAA	TACACCAAAA
28464	28728	144	264	AGGAAGACCT	TAAATTCCCT	GCAATCCTGC	TAACAATGCT
28465	28694	270	229	GGAAGACCTT	AAATTCCCTC	GCCTTGAATA	CACCAAAAGA
28465	28730	115	265	GGAAGACCTT	AAATTCCCTC	AATCCTGCTA	ACAATGCTGC
28466	28853	153	387	GAAGACCTTA	AATTCCCTCG	CGCAACAGTT	CAAGAAATTC
28489	28730	123	241	ACAAGGCGTT	CCAATTAACA	AATCCTGCTA	ACAATGCTGC
28493	28670	427	177	GGCGTTCCAA	TTAACACCAA	ATCATATGGG	TTGCAACTGA
28494	28728	143	234	GCGTTCCAAT	TAACACCAAT	GCAATCCTGC	TAACAATGCT
28495	28679	274	184	CGTTCCAATT	AACACCAATA	GTTGCAACTG	AGGGAGCCTT
28495	28649	209	154	CGTTCCAATT	AACACCAATA	TATGGTGCTA	ACAAAGACGG
28495	28730	197	235	CGTTCCAATT	AACACCAATA	AATCCTGCTA	ACAATGCTGC
28496	28672	267	176	GTTCCAATTA	ACACCAATAG	CATATGGGTT	GCAACTGAGG
28496	28679	182	183	GTTCCAATTA	ACACCAATAG	GTTGCAACTG	AGGGAGCCTT
28503	28728	131	225	TTAACACCAA	TAGCAGTCCA	GCAATCCTGC	TAACAATGCT
28505	28672	1852	167	AACACCAATA	GCAGTCCAGA	CATATGGGTT	GCAACTGAGG
28505	28679	375	174	AACACCAATA	GCAGTCCAGA	GTTGCAACTG	AGGGAGCCTT
28505	28576	171	71	AACACCAATA	GCAGTCCAGA	CGGTAAAATG	AAAGATCTCA
28514	28573	581	59	AGCAGTCCAG	ATGACCAAAT	TGACGGTAAA	ATGAAAGATC
28524	28574	1016	50	ATGACCAAAT	TGGCTACTAC	GACGGTAAAA	TGAAAGATCT
28525	28576	4631	51	TGACCAAATT	GGCTACTACC	CGGTAAAATG	AAAGATCTCA
28525	28679	115	154	TGACCAAATT	GGCTACTACC	GTTGCAACTG	AGGGAGCCTT
28525	28624	109	99	TGACCAAATT	GGCTACTACC	AACTGGGCCA	GAAGCTGGAC
28525	28571	102	46	TGACCAAATT	GGCTACTACC	GGTGACGGTA	AAATGAAAGA
28530	28576	199	46	AAATTGGCTA	CTACCGAAGA	CGGTAAAATG	AAAGATCTCA
28576	28605	142	29	CGGTAAAATG	AAAGATCTCA	GGTATTTCTA	CTACCTAGGA
28644	28725	497	81	TTCCCTATGG	TGCTAACAAA	CCCGCAATCC	TGCTAACAAT
28664	28728	427	64	GACGGCATCA	TATGGGTTGC	GCAATCCTGC	TAACAATGCT
28679	28730	362	51	GTTGCAACTG	AGGGAGCCTT	AATCCTGCTA	ACAATGCTGC
28898	28935	1741	37	TCTCCTGCTA	GAATGGCTGG	CTCTTGCTTT	GCTGCTGCTT
28898	28934	808	36	TCTCCTGCTA	GAATGGCTGG	GCTCTTGCTT	TGCTGCTGCT
28898	28930	177	32	TCTCCTGCTA	GAATGGCTGG	TGCTGCTCTT	GCTTTGCTGC
28898	28936	163	38	TCTCCTGCTA	GAATGGCTGG	TCTTGCTTTG	CTGCTGCTTG
28903	28935	219	32	TGCTAGAATG	GCTGGCAATG	CTCTTGCTTT	GCTGCTGCTT
29010	29064	148	54	GCCAAACTGT	CACTAAGAAA	AACGTACTGC	CACTAAAGCA
29012	29036	127	24	CAAACTGTCA	CTAAGAAATC	GCTGAGGCTT	CTAAGAAGCC
29013	29081	259	68	AAACTGTCAC	TAAGAAATCT	GCATACAATG	TAACACAAGC
29015	29093	147	78	ACTGTCACTA	AGAAATCTGC	ACACAAGCTT	TCGGCAGACG
29069	29093	5466	24	ACTGCCACTA	AAGCATACAA	ACACAAGCTT	TCGGCAGACG
29190	29230	258	40	AAATTGCACA	ATTTGCCCCC	AATGTCGCGC	ATTGGCATGG
29192	29231	156	39	ATTGCACAAT	TTGCCCCCAG	ATGTCGCGCA	TTGGCATGGA
29193	29234	110	41	TTGCACAATT	TGCCCCCAGC	TCGCGCATTG	GCATGGAAGT
29263	29307	253	44	GGGAACGTGG	TTGACCTACA	AAGATCCAAA	TTTCAAAGAT
29283	29303	168	20	CAGGTGCCAT	CAAATTGGAT	GACAAAGATC	CAAATTTCAA
29309	29352	882	43	GATCCAAATT	TCAAAGATCA	TTGACGCATA	CAAAACATTC
29309	29342	190	33	GATCCAAATT	TCAAAGATCA	AATAAGCATA	TTGACGCATA
29309	29336	170	27	GATCCAAATT	TCAAAGATCA	TTGCTGAATA	AGCATATTGA
29416	29470	242	54	AACTCAAGCC	TTACCGCAGA	TGCTGCAGAT	TTGGATGATT
29686	29804	432	118	ATCTTTAATC	AGTGTGTAAC	GAAGAGCCCT	AATGTGTAAA
29688	29806	647	118	CTTTAATCAG	TGTGTAACAT	AGAGCCCTAA	TGTGTAAAAT
29690	29812	129	122	TTAATCAGTG	TGTAACATTA	CTAATGTGTA	AAATTAATTT
29709	29792	278	83	AGGGAGGACT	TGAAAGAGCC	GCTGCCTATA	TGGAAGAGCC
29710	29792	3456	82	GGGAGGACTT	GAAAGAGCCA	GCTGCCTATA	TGGAAGAGCC
29710	29790	3272	80	GGGAGGACTT	GAAAGAGCCA	GAGCTGCCTA	TATGGAAGAG
29710	29794	1159	84	GGGAGGACTT	GAAAGAGCCA	TGCCTATATG	GAAGAGCCCT
29710	29776	183	66	GGGAGGACTT	GAAAGAGCCA	AACAATGCTA	GGGAGAGCTG
29711	29790	874	79	GGAGGACTTG	AAAGAGCCAC	GAGCTGCCTA	TATGGAAGAG
29711	29792	665	81	GGAGGACTTG	AAAGAGCCAC	GCTGCCTATA	TGGAAGAGCC
29713	29779	220	66	AGGACTTGAA	AGAGCCACCA	AATGCTAGGG	AGAGCTGCCT
29727	29776	289	49	CCACCACATT	TTCACCGAGG	AACAATGCTA	GGGAGAGCTG
29727	29792	189	65	CCACCACATT	TTCACCGAGG	GCTGCCTATA	TGGAAGAGCC
29727	29766	182	39	CCACCACATT	TTCACCGAGG	GTGTACAGTG	AACAATGCTA
29727	29790	131	63	CCACCACATT	TTCACCGAGG	GAGCTGCCTA	TATGGAAGAG
29728	29766	156	38	CACCACATTT	TCACCGAGGC	GTGTACAGTG	AACAATGCTA
29728	29759	135	31	CACCACATTT	TCACCGAGGC	CGATCGAGTG	TACAGTGAAC
29735	29759	714	24	TTTTCACCGA	GGCCACGCGG	CGATCGAGTG	TACAGTGAAC
29736	29758	137	22	TTTCACCGAG	GCCACGCGGA	ACGATCGAGT	GTACAGTGAA
29737	29760	857	23	TTCACCGAGG	CCACGCGGAG	GATCGAGTGT	ACAGTGAACA
29737	29758	207	21	TTCACCGAGG	CCACGCGGAG	ACGATCGAGT	GTACAGTGAA
29748	29773	118	25	CACGCGGAGT	ACGATCGAGT	GTGAACAATG	CTAGGGAGAG
29750	29776	335	26	CGCGGAGTAC	GATCGAGTGT	AACAATGCTA	GGGAGAGCTG
